NO ./textures/NO_sprite.xpm
SO ./textures/SO_sprite.xpm
WE ./textures/WE_sprite.xpm
EA ./textures/EA_sprite.xpm

F 33,33,99
C 23,34,33

1111111111111111111111111
1000000000000000000000001
1111000000000000000001111
1000000000000000000000001
1000000000000000000000001
1000000111110000000000001
1000000100010000000000001
1000000100010000000000001
1000000100010000000001111
1000000100010000000000001
1000000000000000000001111
1000E00000001000000000001
1000000000000000000000001
1000000000000000000000001
1111000000000000000001111
1000000000000000000000001
1000000000000000000000001
1000000111110000000000001
1000000100010000000000001
1000000100010000000000001
1000000100010000000001111
1000000100010000000000001
1000000000000000000001111
1000000000000000000000001
1000000000000000000000001
1111111111111111111111111