NO ./textures/NO_sprite.xpm
SO ./textures/SO_sprite.xpm
WE ./textures/WE_sprite.xpm
EA ./textures/EA_sprite.xpm

F 33,33,99
C 12,12,12

1111111111111111111
1000000000000000001
1111000000000000011
1000000000000000001
100000000000N000001
1111111111111111111